11111111111110000000000000000000000000000000000000000000000000000000000000000000000000000000000000000000000000000000000000000000000000000001
100100110C0110000000000000000000000000000000000000000000000000000000000000000000000000000000000000000000000000000000000000000000000000000001
11100111001010000000000000000000000000000000000000000000000000000000000000000000000000000000000000000000000000000000000000000000000000000001
10000PEC001000000000000000000000000000000000000000000000000000000000000000000000000000000000000000000000000000000000000000000000000000000001
